_version	    _version
annotate.c	    annotate.c
annotate.h	    annotate.h
ansidecl.h	    ansidecl.h
aout-aout64.h	    aout64.h
aout-ar.h	    aoutar.h
aout-ranlib.h	    aoutran.h
aout-stab.def	    aoutstab.def
aout-stab_gnu.h	    aoutstab.h
blockframe.c	    blockfra.c
bout.h		    bout.h
breakpoint.c	    breakpoi.c
breakpoint.h	    breakpoi.h
buildsym.c	    buildsym.c
buildsym.h	    buildsym.h
c-exp.c		    c-exp.c
c-lang.c	    c-lang.c
c-lang.h	    c-lang.h
c-typeprint.c	    c-typep.c
c-valprint.c	    c-valp.c
call-cmds.h	    callcmds.h
coff-ecoff.h	    coffecof.h
coff-i960.h	    coffi960.h
coff-internal.h	    coffint.h
coffread.c	    coffread.c
command.c	    command.c
command.h	    command.h
complaints.c	    complain.c
complaints.h	    complain.h
copying.c	    copying.c
core.c		    core.c
cp-valprint.c	    cp-valp.c
d2x.c		    d2x.c
d2xt.c		    d2xt.c
dbxread.c	    dbxread.c
defs.h		    defs.h
demangle.c	    demangle.c
demangle.h	    demangle.h
dis-asm.h	    dis-asm.h
dwarf2read.c	    dw2read.c
elf-common.h	    elfcomm.h
elf-dwarf.h	    elfdwarf.h
elf-external.h	    elfext.h
elf-internal.h	    elfint.h
elf-mips.h	    elfmips.h
elfread.c	    elfread.c
environ.c	    environ.c
environ.h	    environ.h
eval.c		    eval.c
exec.c		    exec.c
expprint.c	    expprint.c
expression.h	    express.h
findvar.c	    findvar.c
floatformat.h	    fltform.h
fopen-bin.h	    fopenbin.h
fopen-same.h	    fopensam.h
fork-child.c	    forkchld.c
frame.h		    frame.h
gdb-stabs.h	    gdbstabs.h
gdbcmd.h	    gdbcmd.h
gdbcore.h	    gdbcore.h
gdbtypes.c	    gdbtypes.c
gdbtypes.h	    gdbtypes.h
getopt.h	    getopt.h
i960-dis.c	    i960dis.c
i960-pinsn.c	    i960pins.c
i960-tdep.c	    i960tdep.c
ieee.h		    ieee.h
infcmd.c	    infcmd.c
inferior.h	    inferior.h
inflow.c	    inflow.c
infrun.c	    infrun.c
init.c		    init.c
language.c	    language.c
language.h	    language.h
libiberty.h	    liberty.h
main.c		    main.c
maint.c		    maint.c
mem-break.c	    membreak.c
minsyms.c	    minsyms.c
objfiles.c	    objfiles.c
objfiles.h	    objfiles.h
obstack.h	    obstack.h
parse.c		    parse.c
parser-defs.h	    parsedef.h
partial-stab.h	    partstab.h
printcmd.c	    printcmd.c
procfs.c	    procfs.c
putenv.c	    putenv.c
regex.c		    regex.c
regex.h		    regex.h
remote-hdi.c	    remhdi.c
remote.c	    remote.c
ser-tcp.c	    ser-tcp.c
ser-unix.c	    ser-unix.c
serial.c	    serial.c
serial.h	    serial.h
signals.h	    signals.h
source.c	    source.c
stabsread.c	    stabread.c
stabsread.h	    stabread.h
stack.c		    stack.c
symfile.c	    symfile.c
symfile.h	    symfile.h
symmisc.c	    symmisc.c
symtab.c	    symtab.c
symtab.h	    symtab.h
target.c	    target.c
target.h	    target.h
terminal.h	    terminal.h
thread.c	    thread.c
thread.h	    thread.h
tm-i960.h	    tmi960.h
top.c		    top.c
top.h		    top.h
typeprint.c	    typeprnt.c
typeprint.h	    typeprnt.h
utils.c		    utils.c
valarith.c	    valarith.c
valops.c	    valops.c
valprint.c	    valprint.c
valprint.h	    valprint.h
value.h		    value.h
values.c	    values.c
wait.h		    wait.h
xm-dos.h	    xm-dos.h
