bind.c		bind.c
chardefs.h	chardefs.h
complete.c	complete.c
display.c	display.c
emacs_keymap.c	emacs_ke.c
funmap.c	funmap.c
highc.c		highc.c
history.c	history.c
history.h	history.h
isearch.c	isearch.c
keymaps.c	keymaps.c
keymaps.h	keymaps.h
parens.c	parens.c
readline.c	readline.c
readline.h	readline.h
rldefs.h	rldefs.h
rltty.c		rltty.c
search.c	search.c
signals.c	signals.c
sysdep-dos.h	sysdos.h
tilde.c		tilde.c
tilde.h		tilde.h
vi_keymap.c	vi_keyma.c
vi_mode.c	vi_mode.c
win95.c		win95.c
